111111111111111111
1001011100001010C1
100001110000001001
1P0000000000001001
1000C000000C000001
100000111000000001
1000001E1000000001
100000101000000001
100000000000000001
111111111111111111
