111111111111111111111111111111111111111
1P00E0000000010000000111111111110000011
1C0000C00000000000000000000000000000001
100000000111000000011100000011100000001
100000000000000000000000000000000000001
1000000000000C1111000000001100000000001
100000000001100000000011000000000000001
111111110000000000001000000000000110001
100000000000000001000000001000110000001
111111000000100000000100000000000001001
11111110111111100000000000000000E000001
100000000000C00000000000000000000000001
111111111111111111111111111111111111111